16,16,
################
#.....WWFF.....#
#....D......#..#
#....D......#..#
#....D......#..#
#....D.........#
#....DD........#
#WWWWWWWWWWWWWW#
#..............#
#####.....#....#
#.........#....#
#.........#....#
#..............#
#..............#
#..............#
################
2,2,START
7,3,ITEM,FLIPPER
9,3,ITEM,BOOTS
8,6,ITEM,KATANNA
2,13,ENEMY,DUMB,LEFT
3,13,ENEMY,DUMB,LEFT
4,13,ENEMY,DUMB,LEFT
LEVEL,6
LEADERBOARD
NONE,1000
NONE,1000
NONE,1000
