16,16,
################
#....#WWFF.....#
#....D.........#
#..............#
#..............#
#..............#
#..............#
#..............#
#..............#
#..............#
#..............#
#..............#
#..............#
#..............#
#..............#
################
2,2,START
3,3,ITEM,TOKEN,1
4,3,ITEM,TOKEN,1
6,3,DOOR,TOKEN,2
LEVEL,6
LEADERBOARD
NONE,1000
NONE,1000
NONE,1000
