12,10,
############
#..#.....#G#
#W##..#..#.#
#..#.....#D#
#..........#
#.FF..######
#.T#....T..#
#..#.......#
#..#.......#
############
10,9,START
3,2,ITEM,TOKEN,1
11,4,DOOR,TOKEN,1
11,5,ENEMY,STRAIGHT,LEFT
3,7,TELE,1
9,7,TELE,1
3,9,ITEM,FLIPPER
LEADERBOARD
PLAYER1,34
PLAYER3,37
PLAYER2,38