
123456789ABC
12,10,
############
#....G.....#
#....####WW#
#D####....F#
#.......##.#
#..........#
#......#####
#..##......#
#..........#
############
6,8,START
10,9,ITEM,TOKEN,1
2,8,DOOR,TOKEN,1
6,2,ENEMY,WALL,LEFT
11,6,ITEM,FLIPPER
LEADERBOARD
PLAYER1,34
PLAYER3,37
PLAYER2,38