12,10,
############
#..#.....#G#
#W##..#..#.#
#..#.....#.#
#..........#
#.FF..######
#.T#....T..#
#..#.......#
#..#.......#
############
10,9,START
11,5,ENEMY,STRAIGHT,LEFT
3,7,TELE,9,7
CURRENTTIME,23
LEVEL,1
INVENTORY
FLIPPER
TOKEN,1
